R 1920 1080
NO  ./textures/t0.png
SO ./textures/t1.png
WE ./textures/t2.png
EA ./textures/t3.png
S   ./textures/s0.png
C 79,210, 255
F 37,37, 45

    11111  111111
    10001  100201
  111000111100001
  111110010000001
1110000000000000
12000000000010001
10000000000000001
200000000000S0001
10000000000000001
10000011111100001
1000001    100001
1000001    100001
1100101    111001
1000001    100001
1011111    100001
1000001    100001
1100001    100001
1111111    111111
