R 1990    1080
NO  ./textures/t4.png
SO ./textures/t0.png
WE ./textures/t1.png
EA ./textures/t2.png
S   ./textures/s0.png
 C             200   ,   210    ,     255 
            F                  37,37       ,               45






   01111111111111111111111111111111111111111111111111111111111111111111111111111111111111
   10000000000000000000000000000000000000000000000000000000000000000000000000000000000001
   10000000000000000000000000011111111111111111111111111111111111111111111111111111111001
   1011000001110000000000000110                                                11111110011111111
1111000000000000000000001111                              1111              11110000000000001
1111000000000000000000001                         1111111110011111111111111110000000000000001
1000000000000000011100001                         1000000000000000000000000000000000000000021
1111001100000000110000001                         1000000000000000000000000011111111111111111
1111001100000000110101001                         1000011111111111111100000000001
1100000000000001110000001                         101111             111111111111
1000000000000000110000001                         101
1000200000100000110000001                         101
1100000000100000000000001                         101
1111100000000000000000001                        1101
11111100000000000000000011111111111111111111111111101
11111000000000000000000000000000000000000000000000001
11111000000000000000000000000000000000000000000000001
11111111111111110111111111111111111111111111111111111
1000000000000000000000001
1000S00000000222200000001
1000000000000222200000001
1000000000000222200000001
1000000000000222200000001
1000000200000000002000001
1000000000000000000000001111
1111111111100011111111110001
1111111111102011111111111111
1111111111100011111111111111
0111111111111111111111111111
