R 6300 6400
NO ./textures/t0.png
SO ./textures/t1.png
WE ./textures/t2.png
EA ./textures/t4.png
S   ./textures/pok2.png
F 255,210,   20
C 255,210    ,20

1111111
1     1
1     1
1     1
1     1

1N    1
1     1
1111111
