R  		       10000 10000
NO      	    ./textures/t0.png
S          	    ./textures/t1.png
WE              ./textures/t3.png
EA          	 ./textures/t4.png
SO               	./textures/t4.png
F    255 ,         210,	   20
C               255,210 		   ,20

11111111111111111
1S000000000000001
10111111111111111
111
