R 1920 1080
NO  ./textures/t0.png
SO ./textures/t1.png
WE ./textures/t2.png
EA ./textures/t4.png
S   ./textures/pok2.png
F 255,210,20
C 255,210,20

1111111111111111111111111
1000000000000000000000001
1011000101110000000000001
10010N0101110000020000001
1011000101110000000000001
1000000100110000011100001
1111001100110000110000001
1111001100110000110101001
1100000001000001110000001
1000000000000000110000001
1111111101111110110000001
1100100020100000000000001
1000100000100000100000001
1000100S00100000100000001
1000100000100000100000001
1000002000100000100000001
1000100111100000111111001
1000000000001100100000001
1001111111111000100000001
1000000000001000100000001
1001111111001000100000001
1000000100001000100200001
1000000100000200100000001
1000000100000000100000001
1111111111111111111111111
