R 1920 1080
NO  ./textures/t4.png
SO ./textures/t0.png
WE ./textures/t1.png
EA ./textures/t4.png
S   ./textures/s0.png
C 79,210, 255
F 37,37, 45

1111111111111111111111111
1000000000000000000000001
1011000101110000000000001
1001000101110000020000001
1011000101110000000000001
1000000100110000011100001
1111001100110000110000001
1111001100110000110101001
1100000001000001110000001
1000000000000000110000001
1111111101111110110000001
1100102000100000000000001
1000100200100000100000001
1000100N00100000100000001
1000100200100000100000001
1200002000100000100000001
1000100111100000111111001
1020000000001100100000001
1001111111111000100000001
1000000000001000100000001
1001111111001000100000001
1000000100001000100200001
1000000100000200100000001
1000000100000000100000001
1111111111111111111111111
